000000000
000000000
000000000
000111000
000111000
000111000
000000000
000000000
000000000

000000000
000000000
000110000
000111100
001111100
001111000
000011000
000000000
000000000

000000000
000000000
000011000
000111100
001111110
000111100
000011000
000000000
000000000

000000000
000000000
001111100
001111100
001111100
001111100
001111100
000000000
000000000

000000000
000000000
000011000
000911100
001119110
001191110
000111900
000011000
000000000

001000000
001900000
001100000
001119100
001911100
000001100
000009100
000000100
000000000

000000000
001000100 
011101110
191919191
011111110
001191100
000111000
000010000
000000000

000000000
000000000
001111110
001191110
001111910
001911110
001119110
001111110
000000000

000000000
000000000
119091119
100010101
111010101
001010101
911090109
000000000
000000000